PPPPPPPPPPPPPPPP
PPPPPPPPPPPPPPPP
PPPPPPPPPPPPPPPP
PPPPPPPPPPPPPPPP
PPPPPPPPPPPPPPPP
PFFPPPPPPPPPPFFP
PFFFPPPPPPPPFFFP
PFFFPPHHHHPPFFFP
PFFFPPHHHHPPFFFP
PFFFPPPPPPPPFFFP
PFFPPPPPPPPPPFFP
PPPPPPPPPPPPPPPP
PPPPPPPPPPPPPPPP
PPPPPPPPPPPPPPPP
PPPPPPPPPPPPPPPP
PPPPPPPPPPPPPPPP